00000000000000000000
00000000000000000000
00000000000000000000
00000000000000000000
00002000020000000200
00002053020040030203
00002111121011111211
00002000020000000200
00002000020000000200
00202020020002000200
40202023024002000200
11211121121012111111
00200020020002000000
00200020020002000000
00200020020002000200
30200023020002000253
11210121111111101211
00200020000000000200
00200020000000000200
00200020020000000200
30203020020003004200
11211110121011101211
00200000020000000200
00200000020000000200
00200000020000000200
45240300626030040200
11110111111111111111